second	Second
seconds	Second
minute	Minute
minutes	Minute
quarter	Minute
quarters	Minute
hour	Hour
hours	Hour
clock	HourOfDay
o'clock	HourOfDay
am	DayTime
pm	DayTime
morning	DayTime
afternoon	DayTime
evening	DayTime
night	DayTime
day	Day
days	Day
today	Today
tomorrow	Today
yesterday	Today
monday	DayOfWeek
tuesday	DayOfWeek
wednesday	DayOfWeek
thursday	DayOfWeek
friday	DayOfWeek
saturday	DayOfWeek
sunday	DayOfWeek
week	Week
weeks	Week
fortnight	Week
month	Month
months	Month
january	MonthOfYear
feburary	MonthOfYear
march	MonthOfYear
april	MonthOfYear
may	MonthOfYear
june	MonthOfYear
july	MonthOfYear
august	MonthOfYear
september	MonthOfYear
october	MonthOfYear
november	MonthOfYear
december	MonthOfYear
year	Year
years	Year
century	Year
centuries	Year